+++                 +++++++++
+   +++++++++++++++++++   + +
+ ++++                + + + +
+ +++++++++++++++++++ + + + +
+                     + + + +
+++++++++++++++++++++ + + + +
+   ++                + + + +
+ + ++ +++ ++ +++++++++ + + +
+ +    +   ++B+         + + +
+ + ++ ++++++++++++++++ + + +
+++ ++             ++++ + + +
+++ ++++++++++++++ ++ + + + +
+++             ++    + + + +
++++++ ++++++++ +++++++ + + +
++++++ ++++             +   +
A      ++++++++++++++++++++++